東京都千代田区	四番町
愛知県愛知郡東郷町	春木台
兵庫県南あわじ市	中条広田
福島県双葉郡浪江町	川添
広島県庄原市	口和町宮内
岩手県盛岡市	東山
沖縄県国頭郡金武町	伊芸
大分県玖珠郡九重町	右田
石川県七尾市	中島町笠師
北海道奥尻郡奥尻町	稲穂
群馬県利根郡昭和村	橡久保
徳島県美馬郡つるぎ町	中横）
山口県美祢市	伊佐町奥万倉
愛媛県四国中央市	土居町北野
長野県木曽郡木祖村	菅
茨城県北茨城市	関南町仁井田
熊本県球磨郡相良村	四浦
埼玉県北足立郡伊奈町	小針新宿
大阪府大東市	栄和町
沖縄県島尻郡与那原町	与那原
熊本県阿蘇郡産山村	田尻
長野県上水内郡飯綱町	芋川
沖縄県中頭郡読谷村	比謝矼
愛知県西尾市	西浅井町
静岡県熱海市	咲見町
愛媛県喜多郡内子町	上川
茨城県久慈郡大子町	盛金
和歌山県有田郡広川町	井関
北海道紋別郡西興部村	東興
北海道上川郡上川町	東町
北海道野付郡別海町	西春別
岩手県八幡平市	日泥道ノ下
東京都府中市	北山町
鹿児島県大島郡宇検村	須古
東京都東村山市	富士見町
長崎県西彼杵郡時津町	左底郷
愛知県名古屋市緑区	左京山
埼玉県川越市	山城
山梨県甲斐市	玉川
茨城県古河市	南間中橋
茨城県猿島郡境町	百戸
福岡県田川郡福智町	赤池
静岡県浜松市東区	豊西町
静岡県菊川市	西横地
北海道上川郡新得町	屈足柏町東
沖縄県中頭郡嘉手納町	久得
東京都江東区	豊洲豊洲センタービル
岩手県下閉伊郡田野畑村	茅刈沢
山形県米沢市	万世町桑山
奈良県磯城郡三宅町	屏風
愛知県江南市	木賀町新開
福岡県行橋市	矢山
青森県三戸郡階上町	赤保内
青森県東津軽郡蓬田村	蓬田
神奈川県横浜市金沢区	六浦町
北海道勇払郡むかわ町	文京
北海道爾志郡乙部町	栄野
福岡県福岡市博多区	中洲中島町
鹿児島県曽於市	末吉町上町
三重県多気郡明和町	馬之上
熊本県球磨郡山江村	万江
鹿児島県日置市	東市来町宮田
島根県隠岐郡知夫村	来居
三重県桑名郡木曽岬町	近江島
兵庫県丹波市	氷上町御油
香川県観音寺市	八幡町
北海道紋別郡興部町	富丘
奈良県高市郡明日香村	橘
熊本県玉名市	三ツ川
大阪府寝屋川市	池の瀬町
青森県上北郡おいらせ町	館越
愛媛県伊予郡松前町	上高柳
長野県木曽郡木曽町	新開
鹿児島県大島郡与論町	西区
宮崎県西臼杵郡五ヶ瀬町	鞍岡
青森県南津軽郡藤崎町	久井名舘
熊本県阿蘇郡南小国町	中原
北海道虻田郡豊浦町	幸町
香川県木田郡三木町	鹿伏
岡山県真庭市	赤野
埼玉県入間市	東町
愛知県名古屋市熱田区	波寄町
高知県須崎市	浦ノ内出見
和歌山県東牟婁郡北山村	大沼
京都府京都市伏見区	鍛冶屋町
神奈川県海老名市	大谷
北海道小樽市	花園
宮崎県西諸県郡高原町	蒲牟田
岐阜県可児市	星見台
北海道檜山郡厚沢部町	本町
東京都三鷹市	井口
北海道空知郡上砂川町	下鶉
北海道古宇郡泊村	盃村
京都府宮津市	上世屋
徳島県三好郡東みよし町	西庄
静岡県御殿場市	沼田
北海道岩内郡岩内町	大浜
兵庫県明石市	東山町
島根県邑智郡川本町	三俣
福島県二本松市	宮本
岐阜県安八郡神戸町	柳瀬
栃木県芳賀郡益子町	大沢
埼玉県越谷市	北後谷
大阪府大阪市西区	江戸堀
高知県高岡郡中土佐町	矢井賀甲
大阪府箕面市	粟生外院
岐阜県加茂郡白川町	中川
岩手県北上市	藤沢
三重県尾鷲市	光ケ丘
福島県白河市	結城
千葉県千葉市花見川区	横戸町
北海道空知郡奈井江町	白山
埼玉県比企郡滑川町	みなみ野
兵庫県美方郡香美町	香住区浦上
埼玉県さいたま市浦和区	上木崎
京都府京都市北区	紫野下若草町
山口県岩国市	相ノ谷
山口県萩市	福井下
青森県つがる市	木造桜木
青森県三沢市	越下
長野県下高井郡木島平村	上木島
熊本県上益城郡益城町	小谷
高知県高岡郡佐川町	平野
佐賀県嬉野市	嬉野町吉田
岐阜県揖斐郡大野町	牛洞
愛知県知多郡美浜町	北方
愛知県愛西市	東保町
大分県豊後高田市	梅ノ木
宮城県石巻市	三輪田
三重県鈴鹿市	若松北
高知県高岡郡越知町	鎌井田本村
奈良県橿原市	高殿町
沖縄県島尻郡渡名喜村	渡名喜村一円
山形県天童市	塚野目
大阪府門真市	御堂町
福岡県糟屋郡粕屋町	上大隈
徳島県海部郡美波町	赤松
千葉県香取市	伊地山
静岡県島田市	中河町
宮城県加美郡加美町	鹿原
滋賀県湖南市	夏見
福井県大飯郡おおい町	福谷
愛知県高浜市	二池町
群馬県甘楽郡南牧村	星尾
兵庫県淡路市	富島
徳島県小松島市	芝生町
北海道足寄郡足寄町	南七条
香川県仲多度郡多度津町	南鴨
宮崎県小林市	須木鳥田町
千葉県木更津市	真里谷
大阪府三島郡島本町	大沢
佐賀県西松浦郡有田町	本町
愛知県みよし市	東陣取山
群馬県太田市	東本町
熊本県玉名郡長洲町	長洲
青森県下北郡佐井村	佐井
北海道赤平市	豊里
山梨県北杜市	高根町長沢
山形県東置賜郡高畠町	相森
兵庫県神崎郡市川町	上牛尾
岐阜県安八郡安八町	中須
兵庫県神戸市長田区	前原町
奈良県生駒市	鹿ノ台東
北海道枝幸郡枝幸町	音標
埼玉県さいたま市北区	東大成町
青森県上北郡横浜町	鶏沢
石川県河北郡内灘町	湖西
千葉県香取郡神崎町	藤の台
神奈川県横浜市瀬谷区	宮沢
北海道札幌市豊平区	美園八条
新潟県糸魚川市	須沢
愛知県尾張旭市	狩宿新町
和歌山県伊都郡九度山町	丹生川
山形県最上郡真室川町	三滝
秋田県南秋田郡八郎潟町	川崎
群馬県富岡市	妙義町諸戸
愛知県知多郡南知多町	山海
東京都武蔵野市	境南町
青森県平川市	荒田南岡部
沖縄県国頭郡宜野座村	惣慶
東京都小平市	上水本町
東京都狛江市	東和泉
茨城県つくば市	安食
北海道足寄郡陸別町	利上
千葉県長生郡長柄町	長富
佐賀県杵島郡大町町	大町
秋田県南秋田郡五城目町	川崎
福島県耶麻郡西会津町	下野尻
福岡県春日市	ちくし台
青森県上北郡七戸町	宇道坂
長崎県島原市	先魁町
和歌山県日高郡みなべ町	西本庄
岩手県下閉伊郡岩泉町	下有芸
千葉県香取郡多古町	多古
埼玉県比企郡川島町	出丸中郷
群馬県利根郡川場村	立岩
福岡県京都郡苅田町	鳥越町
福岡県鞍手郡鞍手町	八尋
山形県西村山郡西川町	月岡
大分県国東市	安岐町瀬戸田
熊本県葦北郡芦北町	芦北
鹿児島県熊毛郡屋久島町	中間
千葉県野田市	木野崎
長野県下水内郡栄村	北信
山梨県笛吹市	境川町小山
岡山県備前市	八木山
大分県日田市	上津江町川原
和歌山県西牟婁郡上富田町	南紀の台
群馬県みどり市	笠懸町西鹿田
宮城県遠田郡涌谷町	新中島乙
北海道旭川市	末広５条
徳島県徳島市	大松町
東京都大島町	元町
山形県新庄市	住吉町
岡山県赤磐市	野間
和歌山県伊都郡高野町	杖ケ薮
秋田県雄勝郡東成瀬村	椿川
岡山県浅口郡里庄町	新庄グリーンクレスト
茨城県結城郡八千代町	東大山
群馬県邑楽郡板倉町	大曲
埼玉県さいたま市桜区	西堀
鳥取県八頭郡八頭町	大門
熊本県上益城郡甲佐町	豊内
群馬県吾妻郡長野原町	川原畑
埼玉県吉川市	小松川
福島県伊達市	梁川町田町
北海道常呂郡佐呂間町	永代町
北海道天塩郡遠別町	北里
大阪府柏原市	玉手町
秋田県鹿角市	十和田上向
北海道士別市	大通東
長崎県松浦市	鷹島町船唐津免
神奈川県伊勢原市	石田
兵庫県たつの市	揖西町田井
静岡県周智郡森町	三倉
岩手県九戸郡九戸村	江刺家
高知県土佐市	塚地
神奈川県足柄上郡松田町	松田庶子
山梨県南都留郡鳴沢村	鳴沢村一円
奈良県北葛城郡上牧町	葛城台
北海道室蘭市	築地町
埼玉県比企郡嵐山町	菅谷
千葉県長生郡長南町	水沼
東京都小笠原村	母島
三重県南牟婁郡御浜町	阿田和
長野県下伊那郡高森町	下市田
福島県田村郡小野町	雁股田
千葉県香取郡東庄町	石出
奈良県生駒郡平群町	三里
沖縄県宮古島市	平良島尻
千葉県山武郡芝山町	境
岐阜県恵那市	東野
熊本県阿蘇市	一の宮町手野
東京都小金井市	緑町
岩手県遠野市	上郷町板沢
大阪府枚方市	津田北町
千葉県白井市	けやき台
福島県双葉郡双葉町	長塚
山口県防府市	下右田
愛知県知多郡阿久比町	萩
三重県松阪市	田村町
奈良県大和郡山市	池沢町
新潟県東蒲原郡阿賀町	取上
埼玉県富士見市	渡戸
大阪府堺市美原区	黒山
三重県鳥羽市	桃取町
山形県東田川郡庄内町	福島
北海道二海郡八雲町	緑町
大阪府高石市	高師浜丁
鹿児島県枕崎市	折口町
滋賀県長浜市	湖北東尾上町
三重県三重郡朝日町	向陽台
山形県西村山郡大江町	塩ノ平
千葉県四街道市	旭ケ丘
長野県東筑摩郡麻績村	日
奈良県桜井市	芝
北海道石狩郡新篠津村	西原
富山県魚津市	中央通り
埼玉県東松山市	下青鳥
愛知県清須市	春日野方
茨城県稲敷市	光葉
茨城県坂東市	大口新田
奈良県北葛城郡河合町	高塚台
北海道恵庭市	漁太
神奈川県川崎市多摩区	東三田
福岡県豊前市	梶屋
北海道余市郡赤井川村	曲川
大阪府南河内郡太子町	聖和台
山形県最上郡最上町	満澤
山梨県大月市	駒橋
長野県埴科郡坂城町	南条
沖縄県島尻郡座間味村	慶留間
愛媛県宇和島市	朝日町
沖縄県八重山郡与那国町	与那国
京都府綴喜郡宇治田原町	立川
佐賀県鳥栖市	原町
大分県宇佐市	院内町広瀬
岡山県高梁市	正宗町
群馬県吾妻郡嬬恋村	三原
新潟県三島郡出雲崎町	吉水
愛知県小牧市	応時
大阪府大阪市住吉区	長居
福岡県三井郡大刀洗町	上高橋
静岡県賀茂郡東伊豆町	白田
大分県由布市	挾間町医大ケ丘
北海道中川郡美深町	大通北
東京都羽村市	栄町
新潟県刈羽郡刈羽村	滝谷新田
大阪府堺市堺区	中之町東
北海道虻田郡京極町	三崎
岩手県西磐井郡平泉町	長島
福岡県北九州市八幡西区	星ケ丘
三重県四日市市	波木南台
福島県双葉郡富岡町	〔東京電力福島第二原子力発電所構内〕）
愛知県田原市	赤石
北海道礼文郡礼文町	船泊村
東京都足立区	谷中
沖縄県宜野湾市	野嵩
滋賀県蒲生郡日野町	下駒月
沖縄県国頭郡恩納村	瀬良垣
岐阜県羽島市	足近町
愛知県名古屋市中区	葵
熊本県球磨郡水上村	湯山
香川県丸亀市	大手町
鹿児島県肝属郡南大隅町	佐多郡
熊本県菊池市	七城町岡田
山形県東根市	東根乙
静岡県駿東郡小山町	上野
群馬県利根郡片品村	摺淵
和歌山県西牟婁郡すさみ町	和深川
大阪府羽曳野市	翠鳥園
茨城県日立市	中丸町
兵庫県川辺郡猪名川町	北田原
千葉県浦安市	堀江
静岡県静岡市駿河区	平沢
奈良県吉野郡黒滝村	中戸
宮崎県えびの市	灰塚
栃木県下野市	上坪山
愛知県北設楽郡豊根村	上黒川
岡山県津山市	杉宮
三重県南牟婁郡紀宝町	井田
東京都御蔵島村	御蔵島村一円
山口県大島郡周防大島町	片添
埼玉県比企郡鳩山町	楓ケ丘
福井県越前市	千合谷町
長崎県北松浦郡小値賀町	笛吹郷
北海道檜山郡江差町	上野町
東京都中野区	南台
宮崎県東諸県郡国富町	伊左生
鳥取県米子市	新開
東京都荒川区	東尾久
福岡県柳川市	隅町
青森県西津軽郡鰺ヶ沢町	松代町
山形県寒河江市	仲谷地
岩手県大船渡市	三陸町越喜来
福島県河沼郡柳津町	琵琶首
京都府宇治市	小倉町
山梨県甲府市	西下条町
長野県上伊那郡箕輪町	三日町
佐賀県多久市	南多久町長尾
岐阜県美濃加茂市	清水町
静岡県伊東市	八幡野
北海道河東郡上士幌町	黒石平
東京都目黒区	原町
香川県小豆郡土庄町	豊島家浦
愛媛県今治市	吉海町仁江
岐阜県多治見市	本町
東京都東大和市	上北台
千葉県習志野市	藤崎
東京都西多摩郡瑞穂町	高根
愛知県津島市	葉苅町
佐賀県武雄市	東川登町永野
北海道山越郡長万部町	曙町
東京都立川市	柴崎町
岩手県久慈市	旭町
長野県飯田市	上久堅戊
兵庫県神崎郡福崎町	東田原
福岡県糟屋郡須惠町	上須惠
福島県いわき市	平鯨岡
鹿児島県大島郡和泊町	瀬名
長野県南佐久郡北相木村	北相木村一円
山口県熊毛郡田布施町	川西
福島県郡山市	喜久田町堀之内
広島県江田島市	江田島町宮ノ原
長野県安曇野市	豊科
高知県高岡郡日高村	下分
茨城県土浦市	佐野子
茨城県石岡市	東府中
広島県安芸郡坂町	坂町の次に番地がくる場合
神奈川県逗子市	新宿
山口県柳井市	土手町
高知県吾川郡仁淀川町	用居）
新潟県南魚沼郡湯沢町	神立
大阪府交野市	傍示
愛媛県越智郡上島町	弓削土生
北海道北広島市	東の里
広島県安芸郡府中町	桜ケ丘
新潟県柏崎市	西山町妙法寺
岐阜県不破郡関ケ原町	小池
和歌山県岩出市	今中
大阪府八尾市	南本町
京都府長岡京市	井ノ内
北海道上磯郡知内町	中ノ川
福島県大沼郡金山町	滝沢
北海道檜山郡上ノ国町	神明
福島県西白河郡泉崎村	泉崎
東京都北区	上十条
福岡県遠賀郡遠賀町	虫生津
宮崎県串間市	大納
兵庫県赤穂市	塩屋
高知県香南市	野市町中ノ村
鹿児島県出水郡長島町	指江
兵庫県神戸市須磨区	西落合
東京都渋谷区	笹塚
宮城県黒川郡大郷町	羽生
沖縄県うるま市	赤野
大阪府大阪狭山市	池尻自由丘
福島県須賀川市	袋田
広島県安芸郡海田町	寺迫
東京都青ヶ島村	青ヶ島村一円
宮城県柴田郡川崎町	火の塚山
鹿児島県肝属郡錦江町	田代川原
埼玉県入間郡三芳町	藤久保
北海道根室市	松本町
京都府京都市下京区	大寿町
山形県最上郡戸沢村	神田
長崎県南島原市	加津佐町己
岡山県真庭郡新庄村	新庄村一円
茨城県取手市	清水
大阪府堺市南区	７２４−１
青森県北津軽郡板柳町	高増
東京都調布市	仙川町
新潟県岩船郡粟島浦村	粟島浦村一円
神奈川県川崎市麻生区	向原
沖縄県島尻郡伊是名村	仲田
石川県羽咋市	大町
青森県下北郡大間町	大間
福岡県糟屋郡新宮町	湊坂
愛知県北設楽郡東栄町	本郷
鹿児島県薩摩郡さつま町	白男川
長野県南佐久郡南牧村	海ノ口
岐阜県羽島郡岐南町	下印食
岩手県紫波郡紫波町	佐比内
大阪府大阪市西成区	千本北
北海道苫前郡羽幌町	寿町
静岡県浜松市北区	豊岡町
兵庫県養父市	奥米地
福島県南会津郡南会津町	押戸
愛知県岩倉市	井上町
高知県高知市	梅ノ辻
福島県本宮市	本宮堀切
滋賀県守山市	小島町
滋賀県彦根市	薩摩町
静岡県浜松市西区	馬郡町
北海道名寄市	西六条南
鹿児島県鹿児島市	谷山中央
秋田県山本郡八峰町	八森横間
茨城県笠間市	中市原
福島県喜多方市	関柴町下柴
山口県下関市	ゆめタウン
宮崎県児湯郡都農町	川北
北海道中川郡豊頃町	大津港町
沖縄県石垣市	平久保
神奈川県足柄下郡真鶴町	真鶴
北海道沙流郡日高町	富川北
広島県山県郡北広島町	寺原
岡山県岡山市中区	さい東町
大分県臼杵市	諏訪
熊本県菊池郡菊陽町	津久礼
福岡県八女市	高塚
北海道網走郡津別町	上里
北海道三笠市	弥生藤枝町
福島県岩瀬郡鏡石町	諏訪町
神奈川県横浜市磯子区	新中原町
北海道宗谷郡猿払村	鬼志別北町
兵庫県美方郡新温泉町	前
福島県耶麻郡猪苗代町	町東
長野県東筑摩郡山形村	山形村一円
奈良県宇陀郡御杖村	土屋原
北海道伊達市	末永町
静岡県裾野市	佐野
愛媛県西予市	野村町小松
福島県双葉郡広野町	広洋台
茨城県常総市	曲田
岐阜県瑞浪市	明賀台
北海道空知郡南富良野町	東幾寅
茨城県つくばみらい市	重右衛門新田
福島県南会津郡只見町	田子倉
島根県邑智郡邑南町	高見
埼玉県新座市	新座
新潟県南魚沼市	蟹沢新田
京都府与謝郡伊根町	蒲入
秋田県北秋田市	森吉
奈良県葛城市	尺土
大阪府大阪市北区	菅栄町
新潟県新潟市西蒲区	猿ケ瀬
北海道芦別市	南二条東
鹿児島県熊毛郡中種子町	牧川
広島県広島市中区	本通
静岡県下田市	堀之内
三重県名張市	矢川
茨城県鹿嶋市	荒井
北海道札幌市東区	東苗穂十五条
北海道樺戸郡浦臼町	浦臼第５
宮城県岩沼市	大和
愛知県半田市	日東町
北海道松前郡松前町	江良
北海道有珠郡壮瞥町	久保内
広島県広島市南区	小磯町
青森県東津軽郡平内町	浪打
神奈川県横浜市西区	みなとみらいクイーンズタワーＢ
長崎県北松浦郡佐々町	沖田免
新潟県新潟市南区	大通西
岩手県和賀郡西和賀町	沢内新町
静岡県静岡市葵区	田町
鹿児島県南九州市	川辺町上山田
和歌山県西牟婁郡白浜町	十九渕
長崎県佐世保市	宮地町
愛知県知立市	栄
奈良県生駒郡斑鳩町	龍田
山口県宇部市	松山町
青森県北津軽郡中泊町	小泊水澗
福島県伊達郡国見町	鳥取
長野県上伊那郡中川村	四徳
岡山県都窪郡早島町	早島
新潟県北蒲原郡聖籠町	二本松
福島県耶麻郡磐梯町	磐梯
埼玉県加須市	南篠崎
福井県南条郡南越前町	甲楽城
滋賀県犬上郡豊郷町	上枝
大阪府大阪市東淀川区	北江口
北海道久遠郡せたな町	北檜山区栄
石川県能美郡川北町	サンコーポラス
滋賀県野洲市	永原
大分県竹田市	渡瀬
愛知県名古屋市千種区	城山新町
石川県能美市	鍋谷町
福島県西白河郡矢吹町	大久保
東京都品川区	南品川
富山県南砺市	焼野
熊本県阿蘇郡小国町	北里
新潟県上越市	飯
熊本県球磨郡五木村	乙
富山県黒部市	釈迦堂
愛媛県西条市	丹原町来見
高知県幡多郡黒潮町	入野
新潟県小千谷市	船岡
埼玉県春日部市	銚子口
高知県安芸郡安田町	中ノ川
愛媛県伊予郡砥部町	重光
北海道幌泉郡えりも町	１５８〜３５４
千葉県匝瑳市	栢田
宮崎県東臼杵郡諸塚村	川内
北海道利尻郡利尻町	仙法志
東京都台東区	清川
栃木県芳賀郡芳賀町	上延生
香川県高松市	上福岡町
東京都西多摩郡奥多摩町	境
北海道川上郡標茶町	旭
奈良県宇陀市	菟田野宇賀志
兵庫県相生市	陸
神奈川県横浜市青葉区	恩田町
三重県桑名市	北寺町
大阪府大阪市城東区	森之宮
福岡県北九州市戸畑区	千防
北海道夕張郡由仁町	東三川
秋田県横手市	十文字町西原２番町
熊本県上天草市	松島町阿村
長野県上水内郡小川村	高府
長野県小諸市	乗瀬
静岡県静岡市清水区	興津清見寺町
茨城県龍ケ崎市	東町
北海道紋別市	渚滑町川向
福島県相馬郡飯舘村	須萱
石川県羽咋郡宝達志水町	子浦
北海道上川郡東神楽町	１４号
沖縄県国頭郡東村	有銘
愛知県名古屋市中川区	小本
山形県西置賜郡白鷹町	高岡
福岡県田川郡川崎町	川崎
長野県南佐久郡佐久穂町	高野町
広島県安芸高田市	吉田町高野
佐賀県伊万里市	大川内町丙
岩手県二戸市	浄法寺町漆沢下平
静岡県浜松市天竜区	水窪町地頭方
岡山県英田郡西粟倉村	影石
岩手県一関市	中沢
和歌山県東牟婁郡太地町	太地
神奈川県横浜市鶴見区	東寺尾
山梨県南都留郡忍野村	内野
群馬県多野郡上野村	野栗沢
愛知県知多郡東浦町	藤江
奈良県御所市	冨田
大阪府豊能郡能勢町	稲地
岡山県浅口市	鴨方町深田
佐賀県杵島郡白石町	田野上
山口県山口市	東山
宮崎県西臼杵郡高千穂町	河内
新潟県佐渡市	北狄
福井県敦賀市	角鹿町
京都府京都市左京区	上高野上荒蒔町
広島県三次市	三和町敷名
北海道余市郡仁木町	長沢南
奈良県吉野郡天川村	和田
鳥取県西伯郡大山町	高橋
山梨県南巨摩郡富士川町	鹿島
栃木県鹿沼市	上日向
新潟県新潟市東区	松園
愛知県岡崎市	法性寺町
静岡県焼津市	藤守
秋田県雄勝郡羽後町	田代
福岡県糟屋郡久山町	山田
山形県最上郡鮭川村	石名坂
沖縄県浦添市	伊祖
宮崎県日向市	伊勢ケ浜
神奈川県川崎市幸区	東小倉
岡山県玉野市	長尾
北海道様似郡様似町	鵜苫
群馬県邑楽郡邑楽町	藤川
北海道河西郡芽室町	芽室北
群馬県館林市	小桑原町
福島県西白河郡中島村	二子塚
愛知県名古屋市守山区	大牧町
北海道空知郡中富良野町	東１線北
大阪府大阪市天王寺区	下寺町
北海道阿寒郡鶴居村	下久著呂
宮城県宮城郡松島町	竹谷
北海道標津郡標津町	北四条
愛媛県松山市	雄郡
福島県福島市	北中川原
沖縄県島尻郡渡嘉敷村	阿波連
青森県下北郡東通村	尻労
熊本県八代郡氷川町	若洲
鹿児島県姶良市	蒲生町北
静岡県浜松市浜北区	本沢合
静岡県榛原郡川根本町	青部
大阪府茨木市	永代町
石川県金沢市	田上
福島県石川郡浅川町	染
神奈川県横浜市泉区	上飯田町
三重県津市	稲葉町
群馬県安中市	鷺宮
熊本県阿蘇郡西原村	小森
高知県吾川郡いの町	敷槇
東京都三宅島三宅村	雄山
北海道岩内郡共和町	幌似
山形県東村山郡中山町	柳沢
福井県今立郡池田町	金見谷
宮城県塩竈市	南町
埼玉県北葛飾郡松伏町	田島
青森県中津軽郡西目屋村	居森平
埼玉県比企郡吉見町	下銀谷
山形県東田川郡三川町	横内
茨城県行方市	矢幡
鹿児島県大島郡徳之島町	白井
秋田県能代市	二ツ井町飛根
福島県石川郡古殿町	論田
岐阜県揖斐郡揖斐川町	北方
静岡県駿東郡清水町	下徳倉
熊本県球磨郡球磨村	蔵谷
徳島県板野郡板野町	古城
富山県高岡市	昭和町
北海道新冠郡新冠町	５６７番地）
島根県浜田市	三隅町芦谷
大阪府吹田市	青葉丘北
三重県伊賀市	三田
長野県北佐久郡立科町	宇山
長野県木曽郡大桑村	長野
群馬県桐生市	美原町
新潟県魚沼市	並柳
三重県志摩市	浜島町桧山路
沖縄県国頭郡今帰仁村	渡喜仁
島根県隠岐郡西ノ島町	宇賀
神奈川県足柄上郡大井町	西大井
鹿児島県志布志市	松山町新橋
北海道河東郡音更町	雄飛が丘南区
福岡県嘉麻市	大隈
静岡県浜松市中区	神明町
山梨県北都留郡丹波山村	鴨沢
愛知県稲沢市	井之口町
山口県熊毛郡上関町	祝島
岡山県井原市	芳井町種
鹿児島県南さつま市	加世田宮原
愛知県海部郡大治町	東條
長野県下伊那郡大鹿村	大河原
京都府京都市中京区	西ノ京日扇町
長野県塩尻市	広丘野村
長野県中野市	江部
兵庫県伊丹市	南本町
宮城県宮城郡利府町	花園
北海道上川郡和寒町	西町
宮城県牡鹿郡女川町	高白浜
埼玉県上尾市	中妻
奈良県山辺郡山添村	鵜山
青森県弘前市	石渡
沖縄県国頭郡伊江村	西江前
石川県野々市市	野代
福島県河沼郡湯川村	堂畑
岐阜県美濃市	乙狩
神奈川県相模原市中央区	すすきの町
福島県東白川郡矢祭町	関岡
広島県府中市	上下町矢野
大分県東国東郡姫島村	姫島村一円
静岡県田方郡函南町	畑
北海道札幌市西区	宮の沢三条
長野県諏訪市	霧ケ峰
北海道留萌郡小平町	大椴
長野県木曽郡南木曽町	読書
京都府久世郡久御山町	佐山
神奈川県愛甲郡愛川町	三増
石川県羽咋郡志賀町	灯
北海道河西郡中札内村	西二条北
千葉県茂原市	箕輪
北海道釧路市	阿寒町蘇牛
静岡県榛原郡吉田町	川尻
福岡県朝倉市	柿原
北海道増毛郡増毛町	阿分
北海道樺戸郡新十津川町	花月
茨城県桜川市	青木
岡山県加賀郡吉備中央町	吉川
島根県安来市	広瀬町広瀬
東京都西東京市	北町
東京都国立市	矢川
群馬県藤岡市	下大塚
熊本県阿蘇郡南阿蘇村	白川
静岡県沼津市	千本常盤町
愛知県春日井市	割塚町
岐阜県不破郡垂井町	大石
茨城県守谷市	薬師台
滋賀県大津市	大将軍
愛知県名古屋市東区	東新町
熊本県天草市	久玉町
北海道紋別郡遠軽町	大通北
滋賀県犬上郡甲良町	呉竹
茨城県常陸大宮市	氷之沢
東京都葛飾区	新小岩
和歌山県日高郡印南町	明神川
鳥取県東伯郡三朝町	高橋
東京都八王子市	下恩方町
和歌山県日高郡由良町	小引
長野県下伊那郡泰阜村	泰阜村一円
福岡県大牟田市	七浦町
徳島県板野郡北島町	新喜来
群馬県北群馬郡榛東村	新井
愛知県東海市	富木島町伏見
北海道亀田郡七飯町	軍川
長野県下高井郡野沢温泉村	東大滝
岡山県岡山市東区	目黒町
愛知県海部郡飛島村	金岡
栃木県真岡市	八條
沖縄県八重山郡竹富町	古見
北海道江別市	いずみ野
長野県上伊那郡宮田村	宮田村一円
北海道札幌市南区	白川
新潟県新発田市	飯島乙
北海道白老郡白老町	森野
京都府京都市東山区	東瓦町
鳥取県西伯郡日吉津村	今吉
島根県邑智郡美郷町	惣森
千葉県安房郡鋸南町	下佐久間
岡山県瀬戸内市	邑久町本庄
青森県むつ市	南赤川町
山形県飽海郡遊佐町	小原田
徳島県名西郡神山町	鬼籠野
茨城県那珂市	戸崎
石川県鹿島郡中能登町	東馬場
奈良県生駒郡三郷町	勢野北
愛知県大府市	柊山町
岩手県滝沢市	篠木仁沢瀬
栃木県大田原市	蜂巣
熊本県下益城郡美里町	原町
埼玉県入間郡毛呂山町	平山
広島県呉市	和庄登町
高知県安芸市	桜ケ丘町
青森県三戸郡五戸町	横丁
秋田県にかほ市	象潟町鳥の海
大阪府大阪市港区	築港
福岡県福岡市東区	塩浜
福岡県宗像市	王丸
広島県三原市	大和町篠
北海道枝幸郡中頓別町	上頓別
福島県安達郡大玉村	大山
広島県山県郡安芸太田町	津浪
千葉県鴨川市	太海浜
神奈川県愛甲郡清川村	宮ケ瀬
北海道歌志内市	上歌
山梨県南都留郡西桂町	倉見
鳥取県境港市	朝日町
山梨県中巨摩郡昭和町	築地新田
福岡県筑紫郡那珂川町	松木
秋田県仙北市	角館町上新町
栃木県那須塩原市	塩野崎
佐賀県東松浦郡玄海町	有浦上
埼玉県戸田市	本町
群馬県前橋市	亀里町
兵庫県神戸市北区	星和台
兵庫県芦屋市	東山町
鳥取県倉吉市	旭田町
福島県南相馬市	鹿島区南海老
沖縄県中頭郡中城村	伊集
静岡県伊豆の国市	墹之上
石川県白山市	日向町
新潟県長岡市	小貫
長野県北安曇郡池田町	池田
愛知県海部郡蟹江町	平安
福岡県築上郡築上町	石堂
静岡県袋井市	高尾町
和歌山県日高郡日高川町	上初湯川
北海道雨竜郡雨竜町	第１１町内
栃木県下都賀郡壬生町	元町
埼玉県さいたま市見沼区	堀崎町
埼玉県鴻巣市	小松
茨城県稲敷郡阿見町	中郷
長野県南佐久郡川上村	大深山
千葉県成田市	佐野
京都府福知山市	西本町
奈良県北葛城郡広陵町	百済
宮城県東松島市	大塩
富山県氷見市	新保
福島県石川郡平田村	中倉
鹿児島県薩摩川内市	矢倉町
宮城県栗原市	築館佐野原
和歌山県伊都郡かつらぎ町	花園梁瀬
徳島県勝浦郡勝浦町	三渓
佐賀県三養基郡みやき町	東尾
埼玉県さいたま市西区	指扇領別所
三重県度会郡大紀町	滝原
高知県香美市	土佐山田町小田島
鳥取県日野郡日野町	別所
山梨県南都留郡富士河口湖町	精進
千葉県南房総市	富浦町豊岡
東京都町田市	高ケ坂
大阪府南河内郡河南町	上河内
愛知県名古屋市南区	赤坪町
北海道余市郡余市町	大川町
青森県南津軽郡田舎館村	大曲
岩手県奥州市	前沢区鳥待小屋
福岡県筑紫野市	天拝坂
茨城県常陸太田市	玉造町
広島県尾道市	正徳町
宮城県名取市	ゆりが丘
北海道虻田郡倶知安町	南十条東
神奈川県三浦郡葉山町	堀内
和歌山県有田郡有田川町	野田
山形県最上郡大蔵村	鍵金野
長野県南佐久郡小海町	千代里
京都府綴喜郡井手町	田村新田
新潟県南蒲原郡田上町	羽生田
奈良県磯城郡田原本町	為川南方
岐阜県本巣市	見延
青森県三戸郡田子町	原
東京都文京区	小日向
千葉県千葉市若葉区	多部田町
島根県隠岐郡隠岐の島町	飯美
岡山県笠岡市	港町
埼玉県秩父市	中宮地町
京都府京丹後市	大宮町下常吉
和歌山県日高郡美浜町	浜ノ瀬
北海道斜里郡斜里町	大栄
滋賀県近江八幡市	鷹飼町東
東京都八丈島八丈町	中之郷
新潟県新潟市北区	内沼沖
山形県村山市	白鳥
岩手県岩手郡岩手町	久保
山形県西置賜郡小国町	小国小坂町
秋田県山本郡三種町	森岳
北海道苫小牧市	沼ノ端
奈良県北葛城郡王寺町	南元町
山口県周南市	浜田
大阪府高槻市	玉川
高知県四万十市	中村小姓町
高知県南国市	桑ノ川
埼玉県さいたま市岩槻区	美幸町
島根県雲南市	木次町山方
北海道上川郡比布町	市街地
秋田県由利本荘市	岩城亀田愛宕町
北海道虻田郡洞爺湖町	伏見
岩手県釜石市	野田町
静岡県藤枝市	緑町
北海道上川郡清水町	御影東二条南
福岡県福津市	勝浦
熊本県葦北郡津奈木町	小津奈木
兵庫県三木市	別所町東這田
長野県飯山市	木島
宮崎県東臼杵郡美郷町	南郷区水清谷
熊本県熊本市東区	６丁目）
佐賀県三養基郡上峰町	前牟田
奈良県吉野郡下市町	貝原
福島県耶麻郡北塩原村	大府平
福岡県北九州市八幡東区	荒生田
宮城県宮城郡七ヶ浜町	吉田浜
三重県多気郡大台町	柳原
大阪府摂津市	浜町
群馬県邑楽郡明和町	田島
大分県速見郡日出町	川崎
愛媛県上浮穴郡久万高原町	西谷
熊本県熊本市西区	河内町岳
沖縄県南城市	知念海野
北海道雨竜郡妹背牛町	１区
鳥取県西伯郡伯耆町	福岡原
東京都杉並区	久我山
鹿児島県大島郡天城町	前野
和歌山県東牟婁郡那智勝浦町	南大居
愛知県常滑市	かじま台
福岡県田川郡香春町	採銅所
山形県南陽市	太郎
埼玉県秩父郡横瀬町	芦ケ久保
埼玉県比企郡小川町	中爪
新潟県妙高市	乙吉
宮城県仙台市太白区	郡山
滋賀県草津市	野路東
栃木県河内郡上三川町	西木代
愛媛県八幡浜市	神宮前
大分県別府市	馬場
群馬県渋川市	赤城町長井小川田
山梨県富士吉田市	新倉
大分県中津市	餌指町
山口県下松市	東豊井
和歌山県海南市	野上中
福島県東白川郡塙町	湯岐
神奈川県大和市	桜森
愛知県北名古屋市	鹿田
兵庫県姫路市	飾磨区中島
愛知県蒲郡市	平田町
埼玉県秩父郡長瀞町	本野上
島根県大田市	温泉津町飯原
福岡県遠賀郡岡垣町	黒山
福岡県大野城市	白木原
石川県河北郡津幡町	彦太郎畠
島根県飯石郡飯南町	赤名
北海道網走郡大空町	女満別西六条
北海道浦河郡浦河町	緑町
愛知県北設楽郡設楽町	田口
長崎県諫早市	多良見町東園
沖縄県那覇市	首里儀保町
兵庫県朝来市	和田山町法興寺
滋賀県蒲生郡竜王町	岡屋
鹿児島県指宿市	１０６０３〜１１０１５）
宮城県仙台市若林区	連坊
埼玉県さいたま市大宮区	浅間町
福岡県うきは市	吉井町福益
静岡県御前崎市	池新田
奈良県吉野郡上北山村	白川
福島県会津若松市	花春町
宮城県柴田郡大河原町	大芝
北海道上川郡当麻町	三条東
栃木県佐野市	大古屋町
岡山県勝田郡奈義町	高円
埼玉県羽生市	下岩瀬
三重県三重郡菰野町	大羽根園柴垣町
鹿児島県霧島市	１８３５−２５３
北海道十勝郡浦幌町	栄町
鹿児島県鹿屋市	本町
東京都昭島市	玉川町
北海道札幌市厚別区	上野幌三条
埼玉県飯能市	中藤上郷
北海道利尻郡利尻富士町	鴛泊
長野県諏訪郡富士見町	立沢
長野県木曽郡王滝村	王滝村一円
北海道深川市	二条
千葉県東金市	下谷
神奈川県平塚市	徳延
大阪府泉佐野市	野出町
高知県宿毛市	新田
福島県双葉郡川内村	下川内
沖縄県名護市	運天原
沖縄県中頭郡北谷町	浜川
静岡県三島市	富士見台
埼玉県さいたま市緑区	上野田
静岡県磐田市	小立野
福岡県福岡市早良区	星の原団地
千葉県千葉市緑区	おゆみ野南
高知県長岡郡本山町	下津野
新潟県胎内市	小舟戸
愛知県豊橋市	その他）
北海道網走市	丸万
福島県大沼郡三島町	滝谷
熊本県球磨郡多良木町	久米
新潟県三条市	下坂井
長野県上田市	塩川
岡山県総社市	門田
京都府京都市南区	上鳥羽奈須野町
島根県出雲市	佐田町一窪田
茨城県猿島郡五霞町	原宿台
栃木県那須郡那須町	大島
福岡県遠賀郡水巻町	頃末
大分県豊後大野市	緒方町大化
岐阜県可児郡御嵩町	美佐野
宮崎県延岡市	川原崎町
宮崎県宮崎市	神宮西
岐阜県安八郡輪之内町	福束新田
鹿児島県肝属郡肝付町	前田
福島県双葉郡葛尾村	上野川
茨城県下妻市	伊古立
神奈川県横浜市戸塚区	小雀町
茨城県高萩市	横川
徳島県板野郡上板町	高磯
北海道帯広市	４２丁目）
神奈川県小田原市	矢作
北海道広尾郡広尾町	東三条
福島県伊達郡川俣町	本町
北海道虻田郡真狩村	美原
秋田県秋田市	土崎港南
岩手県上閉伊郡大槌町	吉里吉里
福岡県古賀市	美明
北海道茅部郡鹿部町	本別
北海道川上郡弟子屈町	奥春別
熊本県合志市	上庄
愛知県名古屋市名東区	小池町
愛媛県大洲市	長浜町沖浦丙
宮城県気仙沼市	本吉町中川内
沖縄県宮古郡多良間村	塩川
神奈川県高座郡寒川町	岡田
愛知県一宮市	千秋町勝栗
神奈川県足柄下郡湯河原町	宮上
兵庫県篠山市	佐貫谷
長野県長野市	元善町
富山県中新川郡上市町	神明町
福岡県遠賀郡芦屋町	浜口町
神奈川県相模原市南区	松が枝町
福岡県朝倉郡筑前町	石櫃
長野県下伊那郡下條村	睦沢
栃木県矢板市	東町
愛知県碧南市	大坪町
熊本県上益城郡山都町	御所
大分県佐伯市	海崎
秋田県山本郡藤里町	大沢
栃木県塩谷郡塩谷町	上平
北海道美唄市	癸巳町奔美唄
茨城県筑西市	鷺島
福岡県北九州市若松区	大池町
長崎県東彼杵郡波佐見町	中尾郷
青森県下北郡風間浦村	易国間
和歌山県新宮市	別当屋敷町
東京都東久留米市	本町
岡山県勝田郡勝央町	美野
長崎県南松浦郡新上五島町	船崎郷
千葉県夷隅郡御宿町	高山田
秋田県湯沢市	表町
富山県小矢部市	道坪野
愛知県名古屋市天白区	鴻の巣
埼玉県久喜市	菖蒲町菖蒲
福岡県宮若市	宮田
新潟県新潟市江南区	鐘木
大阪府守口市	来迎町
徳島県名西郡石井町	石井
沖縄県中頭郡北中城村	美崎
茨城県小美玉市	東田中
長崎県長崎市	風頭町
鹿児島県伊佐市	大口針持
岐阜県海津市	海津町平原
山梨県中央市	一町畑
長野県北安曇郡松川村	松川村一円
北海道上磯郡木古内町	木古内
埼玉県所沢市	久米
香川県東かがわ市	三本松
岡山県苫田郡鏡野町	山城
福島県南会津郡檜枝岐村	下ノ台
秋田県潟上市	飯田川金山
高知県室戸市	吉良川町丙
北海道上川郡美瑛町	白金
栃木県下都賀郡野木町	若林
埼玉県さいたま市南区	関
千葉県館山市	洲宮
北海道島牧郡島牧村	大平
北海道函館市	石倉町
島根県松江市	新庄町
宮城県伊具郡丸森町	岡巻
北海道茅部郡森町	栄町
山口県長門市	通
和歌山県海草郡紀美野町	中田
北海道上川郡東川町	松山温泉
神奈川県横浜市港北区	篠原町
奈良県天理市	石上町
長野県南佐久郡南相木村	南相木村一円
鳥取県鳥取市	末広温泉町
秋田県北秋田郡上小阿仁村	五反沢
沖縄県島尻郡八重瀬町	伊覇
山形県尾花沢市	丹生
奈良県吉野郡吉野町	佐々羅
大阪府和泉市	三林町
和歌山県御坊市	湯川町小松原
沖縄県島尻郡伊平屋村	我喜屋
岩手県九戸郡野田村	野田
長野県下伊那郡天龍村	平岡
福島県岩瀬郡天栄村	白子
宮崎県北諸県郡三股町	花見原
福岡県大川市	酒見
沖縄県国頭郡国頭村	宇良
岡山県岡山市北区	間倉
高知県安芸郡芸西村	西分甲
鹿児島県鹿児島郡三島村	黒島
広島県大竹市	白石
青森県上北郡野辺地町	松ノ木
埼玉県行田市	関根
福岡県田川郡糸田町	貴船
愛知県日進市	折戸町
愛知県豊田市	深見町
北海道雨竜郡北竜町	和
宮城県柴田郡村田町	薄木
鳥取県西伯郡南部町	井上
山形県最上郡舟形町	舟形
長野県佐久市	長土呂
北海道札幌市北区	拓北二条
神奈川県足柄上郡開成町	宮台
長野県諏訪郡下諏訪町	町屋敷
東京都多摩市	永山
北海道砂川市	５４３番地）
北海道虻田郡ニセコ町	西富
福岡県福岡市南区	若久団地
大阪府南河内郡千早赤阪村	東阪
兵庫県神戸市中央区	八幡通
福井県丹生郡越前町	細野
北海道紋別郡湧別町	西芭露
宮崎県日南市	南郷町贄波
福岡県福岡市中央区	城内
福島県石川郡玉川村	岩法寺
北海道北見市	柏木
長野県千曲市	八幡
千葉県千葉市中央区	稲荷町
北海道雨竜郡沼田町	北竜
愛媛県北宇和郡鬼北町	上鍵山
北海道夕張市	鹿島富士見町
福島県南会津郡下郷町	野際新田
北海道空知郡南幌町	中央
青森県十和田市	西二番町
大阪府堺市北区	東三国ケ丘町
青森県三戸郡南部町	大向
東京都大田区	北千束
大阪府大阪市西淀川区	千舟
鹿児島県いちき串木野市	生福
千葉県佐倉市	内田
香川県香川郡直島町	直島町一円
兵庫県三田市	ゆりのき台
長野県下伊那郡阿南町	西條
大阪府泉南郡田尻町	りんくうポート北
新潟県中魚沼郡津南町	芦ケ崎
石川県鳳珠郡穴水町	鹿島
東京都墨田区	横網
鹿児島県阿久根市	鶴見町
茨城県東茨城郡茨城町	長岡
福井県吉田郡永平寺町	松岡渡新田
鹿児島県出水市	明神町
岡山県小田郡矢掛町	下高末
長野県小県郡青木村	奈良本
兵庫県西脇市	堀町
大分県杵築市	杵築
長野県北安曇郡小谷村	中小谷丙
鹿児島県大島郡知名町	上平川
岩手県花巻市	中北万丁目
福岡県北九州市小倉南区	沼
沖縄県糸満市	摩文仁
青森県上北郡六戸町	通目木
兵庫県川西市	清和台東
広島県豊田郡大崎上島町	原田
北海道厚岸郡浜中町	貰人
大阪府大阪市大正区	千島
山梨県山梨市	七日市場
長崎県雲仙市	千々石町庚
滋賀県東近江市	中岸本町
宮崎県児湯郡新富町	下富田
長野県北佐久郡軽井沢町	軽井沢
鳥取県東伯郡湯梨浜町	原
茨城県稲敷郡河内町	源清田
長野県上水内郡信濃町	熊坂
東京都あきる野市	深沢
福井県あわら市	蓮ケ浦
青森県東津軽郡今別町	大泊
香川県さぬき市	小田
大分県大分市	竹矢
山梨県南巨摩郡南部町	中野
神奈川県中郡二宮町	富士見が丘
兵庫県神戸市兵庫区	下沢通
高知県土佐清水市	緑ケ丘
宮城県仙台市青葉区	中山台西
福岡県糟屋郡篠栗町	田中
奈良県高市郡高取町	丹生谷
大阪府池田市	建石町
奈良県奈良市	北市町
熊本県荒尾市	野原
埼玉県児玉郡美里町	関
京都府与謝郡与謝野町	加悦
茨城県かすみがうら市	有河
大阪府岸和田市	中井町
神奈川県横浜市南区	南吉田町
千葉県鎌ケ谷市	南鎌ケ谷
香川県綾歌郡綾川町	牛川
宮城県本吉郡南三陸町	志津川小森
沖縄県国頭郡大宜味村	田嘉里
千葉県いすみ市	日在
神奈川県足柄下郡箱根町	底倉
東京都世田谷区	上用賀
三重県度会郡度会町	当津
大阪府泉北郡忠岡町	忠岡中
長崎県大村市	西大村本町
奈良県吉野郡十津川村	猿飼
栃木県芳賀郡市貝町	羽仏
福岡県北九州市門司区	片上海岸
広島県広島市安佐北区	白木町古屋
福岡県八女郡広川町	水原
群馬県吾妻郡草津町	草津
大阪府大阪市福島区	海老江
栃木県小山市	生良
熊本県阿蘇郡高森町	永野原
長野県下伊那郡売木村	売木村一円
岐阜県加茂郡坂祝町	黒岩
京都府相楽郡南山城村	南大河原
宮崎県東臼杵郡椎葉村	松尾
神奈川県三浦市	三崎町城ケ島
三重県熊野市	木本町
神奈川県秦野市	若松町
兵庫県神崎郡神河町	南小田
長野県下伊那郡根羽村	根羽村一円
佐賀県神埼郡吉野ヶ里町	大曲
栃木県那須郡那珂川町	大山田上郷
奈良県吉野郡川上村	人知
福岡県糟屋郡宇美町	障子岳南
長崎県壱岐市	郷ノ浦町田中触
北海道広尾郡大樹町	東本通
愛知県犬山市	楽田一色浦
広島県広島市佐伯区	五日市町下小深川
群馬県伊勢崎市	堤下町
三重県いなべ市	北勢町奥村
熊本県熊本市中央区	岡田町
大阪府泉南市	別所
北海道石狩郡当別町	対雁
三重県度会郡玉城町	蚊野
栃木県足利市	粟谷町
鹿児島県大島郡龍郷町	安木屋場
福岡県築上郡吉富町	土屋
福島県大沼郡会津美里町	高田前川原
京都府綾部市	向田町
広島県東広島市	西条町吉行
大阪府豊中市	岡町北
北海道中川郡中川町	富和
埼玉県白岡市	千駄野
徳島県海部郡牟岐町	辺川
岡山県新見市	西方
北海道寿都郡寿都町	渡島町
北海道河西郡更別村	上更別
茨城県結城市	新堤仲通り
滋賀県甲賀市	甲賀町櫟野
佐賀県佐賀市	蓮池町古賀
長野県伊那市	前原
北海道河東郡鹿追町	北鹿追北
徳島県阿南市	中大野町
佐賀県藤津郡太良町	大浦甲
和歌山県有田市	宮原町新町
兵庫県加西市	東長町
北海道札幌市中央区	南五条東
愛知県名古屋市昭和区	御器所通
北海道瀬棚郡今金町	鈴金
愛媛県東温市	山之内
滋賀県犬上郡多賀町	霊仙
福井県大飯郡高浜町	紫水ケ丘
福岡県太宰府市	白川
福井県大野市	茜町
埼玉県熊谷市	押切
北海道雨竜郡秩父別町	８条
東京都福生市	武蔵野台
茨城県東茨城郡城里町	上入野
鹿児島県大島郡大和村	思勝
岩手県二戸郡一戸町	一戸
新潟県燕市	吉田浜首
石川県かほく市	宇気
高知県幡多郡三原村	芳井
東京都稲城市	大丸
福岡県鞍手郡小竹町	南良津
滋賀県栗東市	上鈎
徳島県鳴門市	大津町徳長
北海道樺戸郡月形町	知来乙
熊本県天草郡苓北町	上津深江
福岡県京都郡みやこ町	犀川花熊
三重県伊勢市	御薗町小林
千葉県柏市	泉村新田
大阪府大阪市東住吉区	照ケ丘矢田
三重県北牟婁郡紀北町	海山区河内
山形県最上郡金山町	上台
栃木県宇都宮市	上大曽町
埼玉県狭山市	鵜ノ木
北海道上川郡剣淵町	仲町
大阪府泉大津市	戎町
岩手県胆沢郡金ケ崎町	西根
秋田県鹿角郡小坂町	小坂
長野県下伊那郡阿智村	駒場
岐阜県飛騨市	古川町金森町
兵庫県揖保郡太子町	立岡
熊本県八代市	泉町樅木
富山県富山市	大泉１区南部
新潟県加茂市	上高柳
沖縄県島尻郡久米島町	山城
宮城県黒川郡富谷町	ひより台
青森県黒石市	二双子
長野県須坂市	仁礼町
京都府船井郡京丹波町	粟野
熊本県人吉市	井ノ口町
静岡県賀茂郡松崎町	那賀
大阪府大阪市東成区	東今里
北海道勇払郡占冠村	上トマム
兵庫県加古郡播磨町	宮西
岩手県岩手郡雫石町	板橋
岐阜県岐阜市	長良葵町
三重県多気郡多気町	土羽
東京都練馬区	豊玉上
島根県益田市	川登町
千葉県印旛郡栄町	麻生
千葉県勝浦市	川津
秋田県男鹿市	戸賀戸賀
福岡県田川郡大任町	今任原
宮城県白石市	上堰
長野県木曽郡上松町	駅前通り
熊本県玉名郡南関町	今
大阪府大阪市此花区	春日出南
埼玉県蓮田市	東
群馬県甘楽郡甘楽町	国峰
千葉県旭市	中谷里
兵庫県佐用郡佐用町	早瀬
京都府京都市上京区	両御霊町
京都府舞鶴市	田井
山梨県南巨摩郡身延町	大野
愛知県名古屋市港区	作倉町
愛知県西春日井郡豊山町	青山
岐阜県加茂郡八百津町	伊岐津志
北海道厚岸郡厚岸町	小島
北海道札幌市手稲区	手稲本町六条
京都府木津川市	加茂町井平尾
京都府相楽郡笠置町	切山
徳島県吉野川市	山川町祗園
岩手県岩手郡葛巻町	葛巻
愛知県名古屋市中村区	笹島町
青森県五所川原市	高野
宮城県亘理郡山元町	小平
東京都新島村	式根島
茨城県水戸市	柵町
埼玉県南埼玉郡宮代町	金原
石川県輪島市	美谷町
福岡県朝倉郡東峰村	小石原鼓
神奈川県厚木市	林
和歌山県有田郡湯浅町	青木
群馬県多野郡神流町	神ケ原
佐賀県杵島郡江北町	下小田
北海道札幌市清田区	清田八条
千葉県八千代市	緑が丘
北海道夕張郡栗山町	南角田
長野県下伊那郡平谷村	平谷村一円
富山県中新川郡立山町	泊新
千葉県富津市	更和
神奈川県相模原市緑区	上九沢
京都府向日市	上植野町
長野県上高井郡小布施町	都住
宮城県角田市	笠島
千葉県袖ケ浦市	吉野田
三重県亀山市	関町沓掛
大阪府堺市西区	鳳南町
新潟県新潟市秋葉区	美善
高知県土佐郡大川村	下切
茨城県潮来市	築地
秋田県大仙市	南外無尻橋
福島県河沼郡会津坂下町	海老細
北海道勇払郡安平町	早来富岡
岐阜県高山市	七日町
神奈川県横浜市港南区	野庭町
長野県北安曇郡白馬村	北城
和歌山県日高郡日高町	産湯
岡山県久米郡美咲町	高城
長崎県東彼杵郡川棚町	五反田郷
島根県鹿足郡津和野町	高峯
北海道岩見沢市	七条東
鹿児島県曽於郡大崎町	假宿
愛媛県伊予市	両沢
山梨県上野原市	鶴川
福島県東白川郡棚倉町	福岡
滋賀県高島市	今津町浜分
福岡県久留米市	三潴町高三潴
神奈川県鎌倉市	今泉
埼玉県秩父郡東秩父村	白石
岐阜県加茂郡川辺町	中川辺
熊本県菊池郡大津町	吹田
愛知県知多郡武豊町	明神戸
北海道目梨郡羅臼町	知床岬
北海道中川郡本別町	栄町
岩手県気仙郡住田町	上有住
千葉県山武郡横芝光町	坂田
長野県下伊那郡松川町	生田
山梨県都留市	田野倉
富山県中新川郡舟橋村	海老江
埼玉県入間郡越生町	龍ケ谷
広島県竹原市	高崎町
宮城県大崎市	古川南新町
千葉県大網白里市	神房
長野県上伊那郡辰野町	沢底
兵庫県神戸市灘区	土山町
神奈川県横浜市栄区	桂台北
岩手県九戸郡軽米町	山内
長崎県西彼杵郡長与町	嬉里郷
愛知県豊明市	栄町
山形県長井市	今泉
和歌山県東牟婁郡串本町	神野川
宮崎県児湯郡木城町	川原
兵庫県神戸市垂水区	舞子台
埼玉県児玉郡上里町	忍保
福岡県築上郡上毛町	成恒
岐阜県土岐市	土岐ヶ丘
熊本県球磨郡湯前町	上村
岩手県宮古市	泉町
徳島県板野郡藍住町	富吉
広島県福山市	東川口町
埼玉県三郷市	半田
長野県茅野市	金沢
山梨県甲州市	勝沼町綿塚
千葉県市原市	糸久
福岡県糸島市	高上
大阪府泉南郡熊取町	大久保中
北海道天塩郡幌延町	五条北
青森県三戸郡新郷村	戸来
長野県諏訪郡原村	柳沢
北海道積丹郡積丹町	余別町
山形県西置賜郡飯豊町	須郷
佐賀県唐津市	呼子町殿ノ浦
滋賀県愛知郡愛荘町	下八木
島根県仁多郡奥出雲町	稲原
愛媛県南宇和郡愛南町	赤水
新潟県阿賀野市	深町
熊本県水俣市	天神町
北海道斜里郡小清水町	倉栄
神奈川県川崎市高津区	蟹ケ谷
熊本県玉名郡玉東町	木葉
三重県員弁郡東員町	鳥取
香川県仲多度郡琴平町	下櫛梨
茨城県鉾田市	駒木根
東京都利島村	利島村一円
熊本県山鹿市	宗方
千葉県山武郡九十九里町	不動堂
沖縄県島尻郡北大東村	港
福岡県小郡市	二タ
茨城県神栖市	土合本町
宮城県柴田郡柴田町	槻木駅西
香川県小豆郡小豆島町	木庄
山形県山形市	滝平
山口県阿武郡阿武町	宇生賀
島根県鹿足郡吉賀町	七日市
神奈川県足柄上郡中井町	井ノ口
山形県鶴岡市	三光町
兵庫県神戸市東灘区	本山中町
香川県坂出市	室町
大阪府大阪市中央区	天満橋京町
岐阜県羽島郡笠松町	中川町
栃木県那須烏山市	曲田
徳島県阿波市	阿波町綱懸
長野県松本市	征矢野
東京都西多摩郡日の出町	大久野
北海道紋別郡滝上町	第２区
長野県下伊那郡豊丘村	神稲
福島県双葉郡楢葉町	井出
岐阜県郡上市	大和町名皿部
奈良県生駒郡安堵町	窪田
徳島県名東郡佐那河内村	上
東京都国分寺市	高木町
新潟県十日町市	稲荷町
北海道天塩郡天塩町	更岸
神奈川県足柄上郡山北町	都夫良野
東京都清瀬市	旭が丘
長野県小県郡長和町	大門
北海道常呂郡置戸町	新和
北海道天塩郡豊富町	幌加
和歌山県田辺市	本宮町上切原
新潟県新潟市西区	小針
大阪府泉南郡岬町	淡輪
岐阜県山県市	片原
北海道富良野市	山部東２４線
京都府乙訓郡大山崎町	円明寺
福島県相馬市	玉野
神奈川県横須賀市	山中町
宮崎県児湯郡川南町	平田
青森県八戸市	石堂
奈良県吉野郡東吉野村	中黒
千葉県船橋市	藤原
岩手県陸前高田市	横田町
熊本県球磨郡あさぎり町	上南
愛知県刈谷市	中手町
長崎県五島市	幸町
奈良県吉野郡大淀町	北六田
福島県双葉郡大熊町	熊川
茨城県稲敷郡美浦村	定光
兵庫県加東市	屋度
埼玉県川口市	戸塚鋏町
京都府京都市右京区	京北中江町
香川県善通寺市	南町
福岡県田川郡赤村	赤
愛媛県北宇和郡松野町	目黒
三重県度会郡南伊勢町	方座浦
静岡県伊豆市	小土肥
長崎県平戸市	早福町
熊本県宇城市	小川町東海東
富山県滑川市	野尻
千葉県山武市	湯坂
鳥取県八頭郡若桜町	茗荷谷
大阪府大阪市淀川区	塚本
大阪府富田林市	桜ケ丘町
三重県三重郡川越町	南福崎
群馬県邑楽郡大泉町	吉田
長野県上高井郡高山村	堀之内
宮城県亘理郡亘理町	南町
東京都西多摩郡檜原村	三都郷
秋田県仙北郡美郷町	野中
福島県大沼郡昭和村	下中津川
福岡県飯塚市	若菜
北海道古宇郡神恵内村	赤石村
兵庫県多可郡多可町	加美区門村
埼玉県ふじみ野市	谷田
兵庫県赤穂郡上郡町	別名
福島県石川郡石川町	形見
北海道上川郡愛別町	愛山
岡山県倉敷市	玉島黒崎
北海道滝川市	江部乙町東
岡山県岡山市南区	築港元町
大阪府大阪市旭区	赤川
兵庫県尼崎市	大島
大阪府四條畷市	塚脇町
愛知県長久手市	岩作隅田
高知県高岡郡津野町	久保川
青森県北津軽郡鶴田町	瀬良沢
沖縄県豊見城市	保栄茂
大阪府大阪市平野区	平野北
鹿児島県熊毛郡南種子町	茎永
東京都神津島村	神津島村一円
大阪府堺市中区	深井畑山町
静岡県浜松市南区	新橋町
宮崎県児湯郡西米良村	上米良
山形県酒田市	浜田
茨城県ひたちなか市	館山
福井県小浜市	新小松原
愛知県あま市	小橋方
北海道河東郡士幌町	中士幌勝和
長野県東御市	祢津
福岡県糟屋郡志免町	志免東
神奈川県横浜市中区	本牧和田
神奈川県川崎市川崎区	池上町
千葉県長生郡一宮町	新地丙
千葉県長生郡白子町	幸治
島根県隠岐郡海士町	福井
京都府相楽郡精華町	山田
北海道千歳市	泉郷
長野県上伊那郡南箕輪村	南箕輪村一円
高知県幡多郡大月町	才角
福岡県北九州市小倉北区	竪林町
長野県東筑摩郡筑北村	坂井
福岡県みやま市	高田町下楠田
広島県広島市西区	井口
岐阜県養老郡養老町	上方
富山県射水市	八幡町
岐阜県本巣郡北方町	高屋伊勢田
東京都板橋区	板橋
長崎県東彼杵郡東彼杵町	八反田郷
静岡県賀茂郡河津町	梨本
千葉県銚子市	新地町
鳥取県東伯郡琴浦町	釛
茨城県北相馬郡利根町	加納新田
新潟県五泉市	土淵
佐賀県鹿島市	飯田
京都府亀岡市	本梅町中野
岩手県九戸郡洋野町	種市第１地割〜第３地割
北海道中川郡音威子府村	音威子府
徳島県板野郡松茂町	豊中
長崎県対馬市	上対馬町唐舟志
長野県大町市	平
和歌山県紀の川市	西大井
山形県東置賜郡川西町	大舟
高知県長岡郡大豊町	黒石
山梨県南巨摩郡早川町	保
愛知県安城市	東端町
愛知県瀬戸市	岩屋町
北海道夕張郡長沼町	西６線南
神奈川県横浜市都筑区	茅ケ崎東
岐阜県各務原市	鵜沼宝積寺町
徳島県美馬市	養泉）
京都府京田辺市	田辺中央
長野県東筑摩郡生坂村	東広津
埼玉県北本市	下石戸下
徳島県那賀郡那賀町	古屋
埼玉県児玉郡神川町	下阿久原
山形県上山市	松山
群馬県吾妻郡中之条町	小雨
栃木県栃木市	大光寺町
北海道白糠郡白糠町	新縫別
茨城県那珂郡東海村	舟石川駅西
北海道上川郡鷹栖町	北野西三条
栃木県塩谷郡高根沢町	上柏崎
東京都青梅市	森下町
埼玉県秩父郡皆野町	野巻
沖縄県島尻郡粟国村	西
大阪府大阪市鶴見区	今津北
愛知県新城市	能登瀬
大阪府大阪市住之江区	北島
千葉県印旛郡酒々井町	下岩橋
千葉県夷隅郡大多喜町	弥喜用
埼玉県坂戸市	今西
北海道上川郡下川町	幸町
鹿児島県鹿児島郡十島村	平島
秋田県南秋田郡大潟村	中央
宮城県遠田郡美里町	小沼
山梨県南アルプス市	在家塚
大阪府阪南市	下出
奈良県宇陀郡曽爾村	伊賀見
東京都中央区	晴海
大阪府堺市東区	草尾
兵庫県高砂市	荒井町若宮町
岐阜県大垣市	長松町
熊本県宇土市	門内町
青森県西津軽郡深浦町	深浦
福岡県福岡市西区	田尻
群馬県沼田市	清水町
千葉県八街市	勢田
福島県田村郡三春町	一本松
高知県安芸郡東洋町	河内
愛知県名古屋市瑞穂区	亀城町
北海道紋別郡雄武町	沢木
奈良県五條市	大野町
福岡県三潴郡大木町	蛭池
秋田県大館市	比内町谷地中
岐阜県加茂郡富加町	大平賀
宮城県登米市	南方町大村前
宮城県多賀城市	東田中
神奈川県藤沢市	湘南台
熊本県熊本市南区	刈草
福井県勝山市	鹿谷町本郷
北海道勇払郡厚真町	厚和
北海道登別市	柏木町
徳島県海部郡海陽町	熟田
佐賀県三養基郡基山町	小倉
北海道中川郡幕別町	忠類明和
埼玉県八潮市	松之木
北海道松前郡福島町	本町
奈良県大和高田市	大中東町
千葉県君津市	福岡
千葉県長生郡睦沢町	長楽寺
高知県安芸郡北川村	加茂
奈良県磯城郡川西町	梅戸
福岡県直方市	永満寺
京都府京都市山科区	御陵大岩
東京都武蔵村山市	榎
福井県坂井市	丸岡町磯部福庄
千葉県市川市	八幡
山梨県西八代郡市川三郷町	鴨狩津向
北海道稚内市	声問
熊本県熊本市北区	武蔵ケ丘
高知県安芸郡奈半利町	乙
東京都港区	港南
佐賀県神埼市	神埼町鶴
北海道磯谷郡蘭越町	黄金
福岡県筑後市	四ケ所
香川県仲多度郡まんのう町	西高篠
静岡県掛川市	今滝
栃木県日光市	一ツ石
岐阜県中津川市	蛭川
北海道日高郡新ひだか町	静内春立
熊本県上益城郡御船町	滝尾
石川県鳳珠郡能登町	秋吉
兵庫県宝塚市	米谷
宮城県仙台市宮城野区	苦竹
山形県東村山郡山辺町	北作
熊本県玉名郡和水町	岩尻
山梨県韮崎市	藤井町駒井
山口県玖珂郡和木町	瀬田
香川県三豊市	三野町大見
栃木県芳賀郡茂木町	神井
新潟県新潟市中央区	古町通
福岡県福岡市城南区	鳥飼
北海道北斗市	向野
神奈川県横浜市旭区	小高町
広島県神石郡神石高原町	新免
宮城県加美郡色麻町	吉田
山梨県北都留郡小菅村	小菅村
岩手県紫波郡矢巾町	高水寺
福井県福井市	舟橋
埼玉県北葛飾郡杉戸町	鷲巣
埼玉県志木市	下宗岡
北海道寿都郡黒松内町	白井川
福井県三方上中郡若狭町	中央
高知県安芸郡馬路村	魚梁瀬
長野県北佐久郡御代田町	御代田
和歌山県橋本市	紀ノ光台
富山県砺波市	東幸町
宮城県刈田郡蔵王町	宮
沖縄県沖縄市	白川
岐阜県関市	片倉町
高知県土佐郡土佐町	下川
神奈川県横浜市神奈川区	浦島町
神奈川県川崎市宮前区	宮崎
長野県上伊那郡飯島町	田切
長野県岡谷市	塚間町
埼玉県深谷市	緑ケ丘
山形県西村山郡朝日町	大沼
北海道留萌市	沖見町
群馬県甘楽郡下仁田町	上小坂
千葉県松戸市	二ツ木
兵庫県神戸市西区	王塚台
千葉県富里市	美沢
岐阜県下呂市	小坂町坂下
広島県広島市安芸区	矢野南
埼玉県本庄市	本町
埼玉県和光市	丸山台
宮城県黒川郡大和町	吉岡
埼玉県草加市	松江
徳島県勝浦郡上勝町	生実
京都府相楽郡和束町	園
大阪府大阪市都島区	善源寺町
長野県下高井郡山ノ内町	平穏
北海道苫前郡初山別村	有明
千葉県千葉市稲毛区	稲毛台町
埼玉県秩父郡小鹿野町	日尾
北海道中川郡池田町	東台
大阪府豊能郡豊能町	新光風台
鹿児島県西之表市	東町
埼玉県さいたま市中央区	新中里
和歌山県東牟婁郡古座川町	平井
愛知県丹羽郡扶桑町	高雄
東京都新宿区	２番）
神奈川県川崎市中原区	小杉町
岩手県下閉伊郡山田町	荒川
沖縄県国頭郡本部町	山里
大阪府大阪市浪速区	難波中
静岡県駿東郡長泉町	下土狩
高知県安芸郡田野町	田野町一円
千葉県千葉市美浜区	豊砂
長野県下伊那郡喬木村	加々須
北海道札幌市白石区	川下
北海道石狩市	厚田区嶺泊
北海道雨竜郡幌加内町	下幌加内
島根県江津市	桜江町坂本
茨城県牛久市	神谷
新潟県見附市	仁嘉町
兵庫県宍粟市	千種町室
愛知県額田郡幸田町	菱池
愛知県名古屋市北区	織部町
静岡県賀茂郡南伊豆町	毛倉野
福岡県中間市	垣生
新潟県西蒲原郡弥彦村	浜首
群馬県吾妻郡高山村	中山
埼玉県比企郡ときがわ町	雲河原
広島県世羅郡世羅町	堀越
京都府八幡市	美濃山野神
千葉県我孫子市	下沼田
埼玉県幸手市	木立
静岡県富士宮市	阿幸地
青森県上北郡六ヶ所村	倉内
岡山県美作市	五名
埼玉県大里郡寄居町	鷹巣
宮崎県西臼杵郡日之影町	八戸
愛媛県新居浜市	星原町
兵庫県加古川市	神野町西条
大阪府大阪市阿倍野区	長池町
群馬県北群馬郡吉岡町	大久保
北海道網走郡美幌町	美富
大阪府河内長野市	岩瀬
千葉県長生郡長生村	曽根
富山県下新川郡朝日町	宮崎
鹿児島県垂水市	田神
福島県田村市	常葉町鹿山
奈良県香芝市	白鳳台
宮城県黒川郡大衡村	中央平
北海道苫前郡苫前町	豊浦
愛知県知多市	南巽が丘
大阪府藤井寺市	小山藤の里町
沖縄県島尻郡南風原町	新川
鹿児島県大島郡喜界町	西目
大分県玖珠郡玖珠町	山下
福井県鯖江市	橋立町
群馬県佐波郡玉村町	八幡原
北海道斜里郡清里町	上斜里
山梨県南都留郡山中湖村	山中
群馬県高崎市	下横町
宮崎県西都市	片内
静岡県湖西市	鷲津
大阪府貝塚市	６４２−３）
熊本県球磨郡錦町	木上
岐阜県揖斐郡池田町	青柳
千葉県流山市	小屋
岐阜県加茂郡東白川村	神土
愛知県豊川市	御津町御馬膳田
長野県駒ヶ根市	２４３３〜２４５０）
大分県津久見市	四浦
埼玉県日高市	猿田上ノ台
兵庫県西宮市	用海町
和歌山県和歌山市	三木町台所町
東京都江戸川区	上篠崎
兵庫県洲本市	五色町下堺
宮崎県児湯郡高鍋町	高鍋町
神奈川県茅ヶ崎市	芹沢
京都府京都市西京区	桂徳大寺南町
鳥取県日野郡江府町	下蚊屋
埼玉県桶川市	朝日
宮城県刈田郡七ヶ宿町	中ノ沢原道下
鳥取県東伯郡北栄町	土下
福島県伊達郡桑折町	成田
山梨県南都留郡道志村	下白井平
広島県安芸郡熊野町	石神
熊本県上益城郡嘉島町	北甘木
大阪府松原市	北新町
北海道古平郡古平町	本町
岡山県久米郡久米南町	羽出木
京都府城陽市	観音堂
北海道標津郡中標津町	南町
新潟県岩船郡関川村	松ケ丘
岡山県和気郡和気町	宇生
長崎県西海市	西彼町小迎郷
奈良県吉野郡下北山村	下池原
岐阜県加茂郡七宗町	神渕
兵庫県小野市	西山町
北海道沙流郡平取町	貫気別
石川県珠洲市	三崎町森腰
兵庫県加古郡稲美町	野谷
宮崎県東諸県郡綾町	入野
広島県広島市東区	愛宕町
山形県西村山郡河北町	西里
北海道空知郡上富良野町	吹上
静岡県富士市	平垣
神奈川県南足柄市	生駒
京都府南丹市	美山町宮脇
東京都日野市	豊田
奈良県吉野郡野迫川村	北今西
青森県三戸郡三戸町	蛇沼
鹿児島県姶良郡湧水町	中津川
鹿児島県大島郡伊仙町	小島
北海道虻田郡留寿都村	泉川
山口県熊毛郡平生町	大野南
青森県上北郡東北町	内蛯沢道ノ上
愛媛県西宇和郡伊方町	明神
青森県青森市	東造道
愛知県丹羽郡大口町	余野
宮崎県都城市	五十町
秋田県南秋田郡井川町	大麦
鳥取県岩美郡岩美町	院内
埼玉県朝霞市	宮戸
山形県北村山郡大石田町	横山
福井県三方郡美浜町	佐田
佐賀県小城市	三日月町樋口
鳥取県八頭郡智頭町	東宇塚
北海道釧路郡釧路町	東陽西
愛知県名古屋市西区	数寄屋町
新潟県村上市	浦田
北海道虻田郡喜茂別町	御園
山口県光市	立野
神奈川県横浜市緑区	森の台
神奈川県座間市	明王
沖縄県島尻郡南大東村	南
宮城県仙台市泉区	住吉台東
神奈川県中郡大磯町	国府新宿
鹿児島県肝属郡東串良町	川西
北海道常呂郡訓子府町	豊坂
鹿児島県大島郡瀬戸内町	花富
岐阜県瑞穂市	生津
神奈川県横浜市保土ケ谷区	保土ケ谷町
高知県高岡郡檮原町	川口
高知県高岡郡四万十町	奥神ノ川
千葉県印西市	内野
滋賀県米原市	村木
静岡県牧之原市	蛭ケ谷
茨城県東茨城郡大洗町	港中央
鹿児島県奄美市	名瀬朝仁町
宮崎県東臼杵郡門川町	加草
香川県綾歌郡宇多津町	平山
福岡県田川郡添田町	津野
福岡県嘉穂郡桂川町	中屋
石川県小松市	希望丘
静岡県賀茂郡西伊豆町	田子
群馬県利根郡みなかみ町	石倉
大阪府東大阪市	菱江
沖縄県中頭郡西原町	嘉手苅
神奈川県綾瀬市	上土棚南
埼玉県鶴ヶ島市	中新田
愛知県弥富市	寛延
広島県廿日市市	桜尾
兵庫県豊岡市	竹野町宇日
長野県東筑摩郡朝日村	針尾
青森県南津軽郡大鰐町	八幡館
埼玉県蕨市	塚越
福島県相馬郡新地町	今泉
青森県東津軽郡外ヶ浜町	三厩増川
福島県東白川郡鮫川村	渡瀬
群馬県邑楽郡千代田町	舞木
広島県広島市安佐南区	長束西
群馬県吾妻郡東吾妻町	奥田
福島県西白河郡西郷村	屋敷裏東
富山県下新川郡入善町	高畠
石川県加賀市	大聖寺新屋敷町
徳島県三好市	三野町加茂野宮
岐阜県大野郡白川村	荻町
東京都豊島区	雑司が谷
栃木県さくら市	穂積
大阪府大阪市生野区	中川
鳥取県日野郡日南町	茶屋
北海道枝幸郡浜頓別町	大通
福岡県田川市	糒
岩手県下閉伊郡普代村	普代
山口県山陽小野田市	奥若山
